14 14
L L L L T T T C C C C C C C
L L L L T T T C T T T T L T
C L L C T T T C T T T T L T
C C C C T T T C T T L L L L
T T T C C C C C C T T L T T
L L C C T C T L C C C L C C
L L L L L C L L L L L L T T
L L L L L C L L L L L L T T
L L T T T C C C C C T T T T 
L L L L T T T T C C T T T T
L L L L T T T C C C C C C C
L L L L T T T C T T T T L T
C L L C T T T C T T T T L T
C C C C T T T C T T L L L L
